property_location,lot,land_price,improv_price,assesed_value,year_built,year_sold
290 S 1ST ST,36,350000,130500,480500,1968,2000
258 N 17TH ST,6,350000,161300,511300,1970,2010
233 N 1ST ST,13,350000,249500,599500,1989,2010
227 N 16TH ST,13,350000,419200,769200,2010,2010
383 N 2ND ST,33,377000,144100,521100,1968,2010
408 N 4TH ST,4,398300,494900,893200,1994,2010
286 N 16TH ST,16,376500,349000,725500,1997,2010
281 N 16TH ST,13,377000,179600,556600,1970,2010
228 N 19TH ST,14,470500,316000,786500,2003,2010
23 N 6TH ST,9,572400,361000,933400,2002,2010
223 N 5TH ST,9,350000,388200,738200,2010,2010
287 N 16TH ST,15,378000,161700,539700,1942,2010
282 N 9TH ST,34,350000,524500,874500,2006,2010
358 N 2ND ST,24,376000,172200,548200,1978,2011
229 N 11TH ST,11,349900,100,350000,2011,2011
358 N 4TH ST,24,376000,106800,482800,1961,2000
218 N 16TH ST,10,315000,316100,631100,2011,2011
111 N 10TH ST,0,350000,432200,782200,2011,2011
1707 N CENTRAL AVE,2,303800,115100,418900,1948,2011
26 N 6TH ST,14,572400,111000,683400,1976,2011
276 N 16TH ST,12,376500,123000,499500,1960,2010
207 N 2ND ST,0,350000,401800,751800,2001,2010
32 N 9TH ST,14,565800,307700,873500,1996,2010
252 N 8TH ST,22,350000,122000,472000,1980,2000
217 N 14TH ST,11,315000,102900,417900,1935,2010
209 S BARNEGAT AVE,3,350000,229100,579100,1992,2010
36 N 7TH ST,16,454100,45000,499100,1930,2010
32 N 12TH ST,14,642000,241400,883400,1950,2010
128 N 7TH ST,22,350000,106100,456100,1952,2011
32 N 19TH ST,12,604200,299500,903700,1987,2011
261 N 17TH ST,5,375500,106100,481600,1957,2000
283 N 3RD ST,33,350000,131300,481300,1969,2011
127 N 17TH ST,1,352100,144900,497000,1942,2011
343 N 8TH ST,17,378000,116000,494000,1955,2011
1815 N OCEAN TER,6,720000,670100,1390100,1984,2011
111 N 19TH ST,5,402500,141100,543600,1960,2011
287 N 7TH ST,35,350000,112200,462200,1965,2011
272 N 16TH ST,10,376000,89200,465200,1960,2011
1914 SUNSET AVE,20,376000,147100,523100,1984,2011
19 N 16TH ST,7,610200,545600,1155800,2010,2011
43 N 23RD ST,15,642000,202700,844700,1954,2011
322 N 3RD ST,10,350000,249200,599200,2000,2000
47 N 23RD ST,17,552000,556800,1108800,2000,2011
113 N 6TH ST,0,350000,158500,508500,1950,2012
223 N 1ST ST,9,350000,216000,566000,1961,2011
312 N 7TH ST,6,350000,101800,451800,1957,2012
274 N 14TH ST,14,315000,112700,427700,1950,2012
2411 N OCEAN AVE,2,1325500,137400,1462900,1950,2012
31 N 14TH ST,11,623700,890500,1514200,2007,2012
1406 N BARNEGAT AVE,21,323700,100700,424400,1980,2012
283 N 6TH ST,39,315000,207200,522200,1999,2012
294 N 6TH ST,48,350000,210000,560000,1981,2012
311 N 11TH ST,5,350000,163900,513900,1996,2010
236 N 5TH ST,16,350000,79100,429100,1945,2010
27 N 12TH ST,11,636000,496000,1132000,1999,2010
360 N 10TH ST,26,400500,236400,636900,1998,2010
362 N 5TH ST,26,376000,260800,636800,2002,2011
287 N 17TH ST,15,788800,216500,1005300,1979,2010
263 N 4TH ST,25,350000,175600,525600,1970,2010
113 S CENTRAL AVE,2,350000,148300,498300,1964,2011
271 N 15TH ST,9,376000,416900,792900,2011,2011
276 DIVISION AVE,32,350000,160300,510300,1960,2011
411 N 3RD ST,5,398300,322100,720400,1996,2010
344 N 13TH ST,20,760000,253100,1013100,1971,2010
246 N 11TH ST,20,350000,308900,658900,2000,2000
109 N 21ST ST,9,315000,109000,424000,1950,2012
1 DIVISION AVE,1,1150000,632100,1782100,1995,2012
1205 N OCEAN AVE,2,1150000,504300,1654300,2005,2012
13 N CENTRAL AVE,3,350000,161400,511400,1964,2012
211 N 18TH ST,5,332500,145400,477900,1985,2012
46 N 25TH ST,14,475800,208200,684000,1985,2012
254 N 15TH ST,4,301000,127700,428700,1960,2012
372 N 3RD ST,30,376000,122500,498500,1970,2012
216 S 1ST ST,8,350000,104700,454700,1962,2012
312 N 14TH ST,6,950800,419100,1369900,1984,2010
334 N 2ND ST,14,375400,100,375500,2011,2011
323 N 1ST ST,9,375500,128500,504000,1965,2011
212 N CENTRAL AVE,3,350000,122900,472900,1975,2011
229 N 11TH ST,11,349900,100,350000,2011,2011
250 N 9TH ST,22,350000,151400,501400,1988,2000
32 N 13TH ST,14,594000,592000,1186000,2008,2011
2313 N OCEAN AVE,3,1050000,57500,1107500,1960,2011
612 N BARNEGAT AVE,44,350000,237900,587900,2009,2011
111 N 10TH ST,0,350000,432200,782200,2011,2011
30 S 1ST ST,10,534600,93600,628200,1950,2011
610 N CENTRAL AVE,2,415600,214900,630500,1950,2011
42 N 21ST ST,18,597000,580800,1177800,2010,2011
2414 BAY VISTA DR,19,358200,222900,581100,1982,2011
342 N 5TH ST,18,350000,136000,486000,1965,2011
260 N 19TH ST,4,409300,702500,1111800,2006,2011
14 N 6TH ST,8,648000,111600,759600,2011,2011
28 N 11TH ST,12,594000,122200,716200,1949,2011
7 N 23RD ST,1,1050000,764100,1814100,1960,2011
313 N 5TH ST,5,350000,125300,475300,1950,2000
282 N 13TH ST,34,350000,204900,554900,1975,2011
225 N 6TH ST,11,350000,143900,493900,1975,2011
387 N 2ND ST,35,377000,352500,729500,1966,2011
51 S 2ND ST,0,479100,346400,825500,2004,2011
2300 N CENTRAL AVE,1,350000,182200,532200,1950,2011
352 N 3RD ST,22,376000,128100,504100,1970,2011
2105 SUNSET AVE,18,742100,559000,1301100,1997,2011
357 N 6TH ST,23,400500,180100,580600,1955,2012
245 N 16TH ST,20,332500,107700,440200,1931,2012
6 N 23RD ST,4,1040000,601600,1641600,2011,2012
2306 N CENTRAL AVE,2,350000,148200,498200,1950,2012
242 DIVISION AVE,18,350000,178000,528000,1958,2012
245 N 17TH ST,19,355500,89100,444600,1956,2012
223 S 1ST ST,9,350000,96800,446800,1958,2012
26 S 1ST ST,8,610200,89500,699700,1950,2012
326 S 2ND ST,12,376000,199500,575500,1968,2012
282 N 2ND ST,34,350000,127300,477300,1962,2012
608 N BARNEGAT AVE,43,350000,441100,791100,2010,2012
353 N 4TH ST,21,376000,126700,502700,1958,2012
372 N 2ND ST,30,413600,83600,497200,1955,2012
2201 N OCEAN AVE,0,1070000,559400,1629400,1993,2012
242 N 5TH ST,18,350000,78700,428700,1945,2012
280 N 17TH ST,14,397200,131900,529100,1950,2000
312 N BARNEGAT AVE,39,350000,141900,491900,1972,2012
386 N 6TH ST,31,1370000,222900,1592900,1954,2012
236 N 14TH ST,18,315000,92300,407300,1952,2012
282 N 10TH ST,34,350000,267700,617700,2002,2012
110 N 21ST ST,8,322000,144300,466300,1958,2012
294 DIVISION AVE,40,433000,198500,631500,1959,2012
304 N 8TH ST,4,350000,193800,543800,1965,2012
380 N 1ST ST,34,760000,177200,937200,1969,2012
323 N 7TH ST,9,350000,140500,490500,1965,2012
29 N 11TH ST,11,594000,115800,709800,1950,2012
232 N 23RD ST,14,378000,141700,519700,1965,2012
213 N 4TH ST,5,350000,136100,486100,1972,2012
313 N 12TH ST,5,377000,192400,569400,1950,2012
1714 OCEAN TERR,6,729000,569600,1298600,2010,2012
213 N CENTRAL AVE,3,350000,95800,445800,1966,2012
315 N 6TH ST,7,350000,299400,649400,2006,2012
304 N 14TH ST,3,398300,110200,508500,1934,2012
273 N 13TH ST,9,350000,139300,489300,1950,2000
1911 SUNSET AVE,3,353300,382900,736200,2000,2000
237 N 17TH ST,15,395500,111900,507400,1960,2000
226 N 4TH ST,12,350000,140800,490800,1973,2000
363 N 3RD ST,25,376000,132200,508200,1965,2000
246 N 12TH ST,20,350000,194900,544900,1985,2000
346 N 8TH ST,20,378000,95800,473800,1963,2000
212 N 17TH ST,8,315000,180100,495100,1960,2000
326 N 8TH ST,12,350000,128700,478700,1970,2000
1808 SUNSET AVE,20,355900,133800,489700,1988,2000
214 N 15TH ST,8,315000,131900,446900,1945,2001
257 S 1ST ST,23,350000,89600,439600,1960,2001
112 N 15TH ST,10,315000,140000,455000,1960,2001
125 N 11TH ST,1,350000,108600,458600,1939,2001
269 N 10TH ST,27,350000,175100,525100,1985,2001
116 N 4TH ST,0,353500,171300,524800,1987,2001
243 N 9TH ST,17,350000,131500,481500,1974,2001
212 N 21ST ST,6,375500,295700,671200,2001,2001
338 N 8TH ST,16,377000,115100,492100,1965,2001
2300 N CENTRAL AVE,1,350000,185200,535200,1950,2001
209 S BARNEGAT AVE,3,350000,229100,579100,1992,2001
300 N 13TH ST,4,377000,166900,543900,1960,2001
294 N 2ND ST,40,350000,120900,470900,1965,2001
112 N 16TH ST,8,362300,111900,474200,1932,2001
253 S 1ST ST,21,350000,102500,452500,1960,2001
328 N 10TH ST,12,375500,156900,532400,1983,2001
310 S 1ST ST,6,336600,124800,461400,1981,2001
282 N 7TH ST,34,367500,126000,493500,1952,2001
108 N 3RD ST,10,295800,119900,415700,1940,2001
2106 N CENTRAL AVE,2,350000,172600,522600,1981,2001
253 N 9TH ST,21,350000,134900,484900,1994,2001
201 N 2ND ST,0,350000,328500,678500,2001,2001
111 N 3RD ST,9,280000,87000,367000,1924,2001
1112 N CENTRAL AVE,3,350000,87000,437000,1945,2001
254 N 15TH ST,4,301000,125600,426600,1960,2002
10 N 6TH ST,6,504000,189400,693400,1930,2002
270 N 6TH ST,38,350000,218100,568100,2001,2003
213 N 15TH ST,7,315000,108700,423700,1950,2003
243 N 22ND ST,17,434700,430300,865000,2003,2003
235 N 19TH ST,17,368900,99500,468400,1952,2003
252 S 1ST ST,22,350000,151000,501000,1961,2003
32 N 24TH ST,12,684000,170200,854200,1960,2003
244 N 7TH ST,20,350000,191100,541100,1951,2001
295 N 10TH ST,37,350000,101000,451000,1960,2001
610 BAY FRONT,27,760000,225600,985600,1987,2001
256 N 9TH ST,24,350000,122700,472700,1953,2001
100 S BARNEGAT AVE,40,336000,199500,535500,2001,2001
362 N 2ND ST,26,376000,355900,731900,2001,2001
1618 SUNSET AVE,23,332500,132400,464900,1955,2001
1506 N BARNEGAT AVE,19,382500,103400,485900,1970,2001
115 N 10TH ST,5,350000,148100,498100,1986,2001
316 N 13TH ST,8,378000,186500,564500,1950,2001
246 N 1ST ST,20,350000,119400,469400,1965,2001
292 N 14TH ST,20,376500,172000,548500,1989,2001
231 N 17TH ST,13,335400,157300,492700,1960,2001
327 N 10TH ST,11,350000,148600,498600,1967,2001
1716 SUNSET AVE,22,356400,228300,584700,1989,2001
237 N 1ST ST,15,350000,172300,522300,1963,2001
1616 N BARNEGAT AVE,20,345100,112100,457200,1950,2000
205 N 11TH ST,1,350000,165800,515800,1930,2001
216 DIVISION AVE,8,350000,188600,538600,1965,2001
31 N 8TH ST,13,496800,256100,752900,1997,2002
263 N 10TH ST,25,350000,150100,500100,1985,2001
32 N 9TH ST,14,565800,320400,886200,1996,2002
412 N 4TH ST,6,398300,141100,539400,1972,2001
124 N 7TH ST,3,377300,123900,501200,1950,2002
36 N 19TH ST,14,564300,222500,786800,1987,2002
1808 SUNSET AVE,20,355900,133800,489700,1988,2002
316 N 7TH ST,8,350000,140900,490900,1956,2002
239 N 15TH ST,19,301000,60400,361400,1930,2002
266 N 6TH ST,36,350000,182100,532100,2001,2002
323 N 12TH ST,9,378000,201700,579700,1965,2002
2307 N LONG BEACH BLVD,10,329600,92900,422500,1948,2002
247 N 6TH ST,21,315000,129200,444200,1967,2002
6 N CENTRAL AVE,2,291200,122900,414100,1985,2002
31 N 9TH ST,13,552000,292500,844500,1992,2002
1503 N CENTRAL AVE,1,303800,90500,394300,1925,2002
807 N OCEAN AVE,2,1000000,315500,1315500,1979,2002
234 N 22ND ST,14,376500,217500,594000,1996,2002
283 DIVISION AVE,33,350000,139200,489200,1960,2002
207 N BARNEGAT AVE,2,350000,128900,478900,1972,2002
317 N 1ST ST,7,375500,109900,485400,1972,2002
513 N BARNEGAT AVE,3,350000,278100,628100,1998,2002
23 N 6TH ST,9,572400,361000,933400,2002,2002
37 N 14TH ST,15,513600,137600,651200,1935,2002
307 N 1ST ST,1,350000,294900,644900,1945,2002
236 N 22ND ST,16,378000,361600,739600,2002,2002
412 N 4TH ST,6,398300,141100,539400,1972,2002
362 N 5TH ST,26,376000,264300,640300,2002,2002
39 S 2ND ST,17,552000,316900,868900,2002,2002
223 N 13TH ST,9,343000,252700,595700,2002,2002
312 N 3RD ST,6,350000,140100,490100,1979,2002
224 S 1ST ST,10,385000,156900,541900,1962,2002
233 N 10TH ST,13,350000,164500,514500,1935,2002
214 N 25TH ST,6,375500,162700,538200,1984,2002
1408 N BARNEGAT AVE,22,323700,96400,420100,1950,2002
411 N 3RD ST,5,398300,322100,720400,1996,2002
40 N 3RD ST,20,496800,291200,788000,1988,2002
386 N 5TH ST,0,752800,234000,986800,1985,2002
40 N 17TH ST,16,674100,216600,890700,1950,2002
32 N 9TH ST,14,565800,320400,886200,1996,2002
313 N 8TH ST,5,350000,162000,512000,1965,2002
212 S 1ST ST,6,367500,121400,488900,1960,2002
282 N 10TH ST,34,350000,267700,617700,2002,2002
272 N 8TH ST,30,376300,178900,555200,1970,2003
217 N 9TH ST,0,350000,293900,643900,1989,2002
22 N 17TH ST,10,572400,338400,910800,2000,2003
45 N 15TH ST,19,552000,261100,813100,1950,2003
37 N 12TH ST,15,552000,419000,971000,1998,2003
226 N 9TH ST,12,350000,244000,594000,2003,2003
813 N OCEAN AVE,3,1000000,269300,1269300,1968,2003
233 N 19TH ST,15,368900,179100,548000,1980,2003
27 N 6TH ST,11,636000,406200,1042200,2003,2003
1613 N CENTRAL AVE,4,352100,118000,470100,1933,2003
357 S 3RD ST,23,400500,129800,530300,1970,2003
245 N 17TH ST,19,355500,87100,442600,1956,2003
16 N 9TH ST,8,678000,165500,843500,1950,2003
214 N 19TH ST,8,335400,204700,540100,1960,2003
273 DIVISION AVE,29,350000,324300,674300,2003,2003
45 DIVISION AVE,21,577800,202600,780400,1960,2003
223 N 8TH ST,9,350000,193500,543500,1995,2003
1719 N OCEAN AVE,4,900000,501900,1401900,1995,2003
324 N 2ND ST,10,545500,187100,732600,1964,2003
349 N 11TH ST,19,1020000,229200,1249200,1976,2003
36 N 24TH ST,14,552000,460100,1012100,2003,2003
1613 N CENTRAL AVE,4,352100,118000,470100,1933,2003
304 N 8TH ST,4,350000,191400,541400,1965,2003
108 N 3RD ST,10,295800,119900,415700,1940,2003
287 N 8TH ST,35,350000,101200,451200,1945,2003
106 N BARNEGAT AVE,38,350000,153800,503800,1981,2003
1215 N BARNEGAT AVE,3,376500,120000,496500,1982,2003
273 N 9TH ST,29,393800,121400,515200,1946,2003
222 N 12TH ST,10,350000,118400,468400,1940,2003
47 N 20TH ST,19,629200,114100,743300,1960,2003
217 N 1ST ST,7,350000,93200,443200,1965,2003
403 N CENTRAL AVE,1,350000,102500,452500,1945,2003
356 N 9TH ST,24,415800,164400,580200,1976,2003
304 N 9TH ST,4,350000,143300,493300,1955,2003
343 N 6TH ST,17,350000,117600,467600,1959,2003
225 N 14TH ST,15,315000,231400,546400,2003,2003
913 N BARNEGAT AVE,3,350000,238300,588300,2001,2003
316 N 6TH ST,8,350000,119500,469500,1965,2003
43 N 24TH ST,13,552000,247700,799700,1969,2003
373 N 3RD ST,29,376000,190000,566000,1965,2003
353 N 2ND ST,21,376000,124900,500900,1966,2003
114 N 11TH ST,6,350000,374200,724200,2003,2003
236 N 8TH ST,16,350000,65700,415700,1960,2003
36 N 12TH ST,16,552000,492600,1044600,2002,2003
1420 SUNSET AVE,21,393800,152800,546600,1949,2003
2111 N OCEAN AVE,3,1095000,610300,1705300,1995,2003
813 N BARNEGAT AVE,3,350000,139600,489600,1988,2003
350 N 12TH ST,20,1020000,373700,1393700,1958,2003
2201 N OCEAN AVE,0,1070000,530900,1600900,1993,2003
304 N 2ND ST,4,376300,180400,556700,1960,2003
316 N 4TH ST,8,350000,115600,465600,1965,2003
233 N 4TH ST,13,350000,112500,462500,1965,2003
432 N 4TH ST,16,450600,242900,693500,1984,2003
263 N 2ND ST,25,350000,189700,539700,1960,2003
228 N 19TH ST,14,470500,307900,778400,2003,2003
253 N 11TH ST,21,350000,283900,633900,1993,2003
236 N 2ND ST,16,350000,171900,521900,1965,2003
261 DIVISION AVE,25,350000,86300,436300,1962,2003
310 S 1ST ST,6,336600,124800,461400,1981,2003
205 N 12TH ST,1,350000,80800,430800,1955,2000
209 N 20TH ST,3,315000,277600,592600,2002,2003
339 N 4TH ST,15,350000,118800,468800,1960,2003
102 N 13TH ST,10,387600,137400,525000,1984,2003
27 DIVISION AVE,13,648000,138500,786500,1950,2003
323 N 2ND ST,9,350000,133200,483200,1965,2003
41 N 20TH ST,17,642000,155800,797800,1950,2003
16 S CENTRAL AVE,1,392100,347200,739300,2001,2003
332 N 4TH ST,14,350000,104200,454200,1965,2003
1607 SUNSET AVE,2,332500,123900,456400,1953,2004
29 N 7TH ST,13,515900,61400,577300,1930,2003
14 N 24TH ST,6,717700,259500,977200,1960,2003
119 N 17TH ST,5,367500,265900,633400,1940,2003
1618 SUNSET AVE,23,332500,132400,464900,1955,2003
503 N CENTRAL AVE,2,350000,227400,577400,2001,2004
1911 SUNSET AVE,3,353300,382900,736200,2000,2003
1911 SUNSET AVE,3,353300,382900,736200,2000,2003
231 N 8TH ST,13,350000,135300,485300,1955,2004
241 N 4TH ST,15,350000,351300,701300,2000,2004
22 N 21ST ST,8,718700,481400,1200100,1991,2004
258 N 2ND ST,24,350000,331100,681100,2004,2004
366 N 9TH ST,28,460600,346300,806900,1970,2004
114 N 17TH ST,8,393800,159900,553700,1962,2004
273 N 9TH ST,29,393800,121400,515200,1946,2003
218 N 23RD ST,8,376000,195000,571000,1950,2004
212 N 23RD ST,6,431800,214900,646700,1952,2004
245 N 6TH ST,21,329000,266700,595700,2002,2004
408 N 4TH ST,4,398300,534700,933000,1994,2004
37 N 16TH ST,15,579600,215300,794900,1932,2004
901 N OCEAN AVE,1,1150000,239100,1389100,1970,2004
294 DIVISION AVE,40,433000,198500,631500,1959,2004
230 S 1ST ST,12,332500,88100,420600,1958,2004
2206 N CENTRAL AVE,2,350000,222400,572400,1985,2004
349 N 1ST ST,19,376000,273100,649100,2003,2004
295 S 2ND ST,37,340800,291000,631800,2002,2004
225 N 6TH ST,11,350000,143400,493400,1975,2004
31 N 6TH ST,13,684000,112000,796000,1940,2004
337 N 8TH ST,15,378000,124000,502000,1965,2004
353 N 10TH ST,21,460600,188800,649400,1970,2004
239 S 2ND ST,15,358800,187900,546700,1959,2004
250 N 3RD ST,22,350000,340800,690800,1992,2004
41 N 15TH ST,17,552000,433800,985800,1970,2004
617 N OCEAN AVE,4,1000000,314000,1314000,1985,2004
273 N 9TH ST,29,393800,121400,515200,1946,2004
15 N 23RD ST,5,727700,269800,997500,1975,2004
285 S 2ND ST,33,376300,193600,569900,1967,2004
17 DIVISION AVE,9,691200,124400,815600,1950,2003
359 N 5TH ST,23,376000,176600,552600,1956,2004
207 N 5TH ST,1,350000,118000,468000,1967,2004
376 N 5TH ST,32,434700,366800,801500,1993,2004
115 N 11TH ST,5,350000,429800,779800,2004,2004
313 N 4TH ST,5,350000,360100,710100,2004,2004
218 N 21ST ST,8,375500,130900,506400,1954,2000
333 N 7TH ST,13,350000,228700,578700,1965,2004
349 N 2ND ST,19,376300,125800,502100,1965,2004
244 S 1ST ST,18,350000,225300,575300,1968,2004
216 N 17TH ST,10,315000,247700,562700,2004,2004
239 S 2ND ST,15,358800,187900,546700,1959,2004
206 N 2ND ST,4,350000,310200,660200,1984,2004
225 N 18TH ST,11,408800,182100,590900,1960,2004
1007 N BARNEGAT AVE,2,350000,199800,549800,1995,2004
1503 N CENTRAL AVE,1,303800,90500,394300,1925,2004
222 N 8TH ST,10,376300,180500,556800,1960,2004
372 N 2ND ST,30,413600,83600,497200,1955,2004
307 N 1ST ST,1,350000,294900,644900,1945,2004
39 N 17TH ST,13,594000,394300,988300,1992,2004
2205 N CENTRAL AVE,2,350000,374900,724900,1997,2004
342 N 2ND ST,18,376000,197800,573800,1953,2004
333 N 3RD ST,13,350000,255200,605200,1965,2004
17 N 12TH ST,7,738000,252400,990400,1940,2004
415 N 4TH ST,3,827700,331400,1159100,1973,2004
270 N 19TH ST,8,371100,372700,743800,1940,2004
230 N 19TH ST,16,368900,261200,630100,2003,2004
216 N 17TH ST,10,315000,247700,562700,2004,2004
273 N 2ND ST,29,402500,183300,585800,1960,2004
357 N 4TH ST,23,376000,234700,610700,1996,2000
2306 N CENTRAL AVE,2,350000,148200,498200,1950,2004
119 N 17TH ST,5,367500,265900,633400,1940,2004
1013 N BARNEGAT AVE,3,350000,143100,493100,1964,2004
213 N 1ST ST,5,350000,110700,460700,1965,2004
307 N OCEAN AVE,3,1000000,486000,1486000,1985,2004
287 N 10TH ST,35,350000,85000,435000,1960,2004
43 N 11TH ST,0,552000,445500,997500,2001,2004
212 DIVISION AVE,6,402500,175600,578100,1965,2004
346 N 9TH ST,20,378000,164500,542500,1959,2004
205 N 16TH ST,1,303800,140700,444500,1968,2004
2401 N CENTRAL AVE,1,367500,292400,659900,1945,2004
26 N 12TH ST,12,594000,312300,906300,1950,2004
233 S 2ND ST,13,315000,110100,425100,1960,2004
27 N 4TH ST,11,594000,412900,1006900,1996,2004
363 N 10TH ST,25,400500,204300,604800,1954,2004
45 S 2ND ST,21,579600,329000,908600,2004,2004
347 N 8TH ST,19,378000,324400,702400,1993,2000
349 N 3RD ST,19,350000,166100,516100,1972,2004
1109 N CENTRAL AVE,2,350000,115700,465700,1955,2004
218 N 6TH ST,12,362300,179900,542200,1917,2004
330 S 1ST ST,14,724000,155600,879600,1952,2004
278 N 8TH ST,32,350000,142600,492600,1950,2000
342 S 2ND ST,18,378000,177700,555700,1968,2004
252 N 5TH ST,22,350000,114600,464600,1945,2004
2412 N CENTRAL AVE,3,350000,176700,526700,1968,2004
1207 N CENTRAL AVE,2,350000,107200,457200,1956,2005
1519 N OCEAN AVE,4,900000,552200,1452200,1996,2004
215 N 18TH ST,7,355500,138600,494100,1940,2004
352 N 6TH ST,22,376000,395400,771400,2004,2005
509 N OCEAN AVE,2,845000,89300,934300,1930,2005
209 S BARNEGAT AVE,3,350000,229100,579100,1992,2005
26 N 1ST ST,12,756000,174800,930800,1947,2005
349 N 4TH ST,19,350000,138800,488800,1960,2005
361 N 9TH ST,25,400500,139400,539900,1960,2005
27 N 6TH ST,11,636000,406200,1042200,2003,2005
262 N 10TH ST,26,378000,97800,475800,1950,2005
248 N 2ND ST,0,437500,117700,555200,1962,2005
2106 N CENTRAL AVE,2,350000,172600,522600,1981,2005
323 N 11TH ST,9,375500,459400,834900,2003,2005
315 S 3RD ST,5,350000,468600,818600,2005,2005
280 N 4TH ST,32,350000,509000,859000,2005,2005
107 N OCEAN AVE,2,1035000,233200,1268200,1960,2005
1614 SUNSET AVE,22,332500,102000,434500,1959,2005
393 N 10TH ST,37,836000,491000,1327000,2000,2004
37 N 14TH ST,15,513600,137600,651200,1935,2004
41 N 15TH ST,17,552000,433800,985800,1970,2005
27 N 9TH ST,11,594000,383100,977100,2002,2005
252 N 11TH ST,22,350000,261500,611500,2005,2005
13 N 9TH ST,5,810000,194600,1004600,1970,2005
336 N 2ND ST,16,376000,130600,506600,1955,2005
111 N 11TH ST,7,420000,91000,511000,1950,2005
204 S 1ST ST,4,350000,134000,484000,1946,2005
217 N 11TH ST,7,350000,62200,412200,1937,2000
294 DIVISION AVE,40,433000,198500,631500,1959,2005
366 N 4TH ST,28,376000,148600,524600,1965,2005
222 N 8TH ST,10,376300,180500,556800,1960,2005
312 S 2ND ST,6,376500,135100,511600,1967,2005
7 N 23RD ST,1,1050000,212300,1262300,1960,2005
386 N 4TH ST,36,377000,144400,521400,1988,2005
267 N 6TH ST,31,350000,141400,491400,1962,2005
112 S BARNEGAT AVE,38,326300,155400,481700,2000,2004
319 S 3RD ST,7,350000,269800,619800,2005,2005
519 N OCEAN AVE,4,1000000,643400,1643400,2003,2005
33 N 15TH ST,13,534600,284600,819200,1992,2005
317 N 8TH ST,7,350000,127600,477600,1962,2005
19 N 9TH ST,7,648000,236500,884500,1925,2005
19 N 14TH ST,7,610200,405700,1015900,2002,2005
272 DIVISION AVE,30,350000,156400,506400,1960,2005
407 N 3RD ST,3,398300,144100,542400,1975,2005
222 N 6TH ST,14,402500,142600,545100,1945,2004
338 N 8TH ST,16,377000,115100,492100,1965,2005
387 N 1ST ST,35,378000,158000,536000,1955,2005
49 N 10TH ST,19,552000,426700,978700,2001,2005
22 N 9TH ST,10,636000,125500,761500,1975,2005
257 N 12TH ST,23,350000,123200,473200,1967,2005
21 N 17TH ST,7,672900,140700,813600,1935,2005
17 N 13TH ST,7,691200,166900,858100,1950,2005
387 N 3RD ST,35,377000,508800,885800,2005,2005
267 N 8TH ST,27,350000,519500,869500,2005,2005
28 N 8TH ST,12,594000,88200,682200,1940,2005
304 N 2ND ST,4,376300,180400,556700,1960,2005
229 N 5TH ST,11,350000,153100,503100,1963,2005
242 N 2ND ST,18,350000,179400,529400,1963,2000
114 S CENTRAL AVE,2,291300,86300,377600,1950,2005
207 S 2ND ST,1,350000,115000,465000,1965,2005
418 N 3RD ST,8,902900,415200,1318100,1995,2005
23 N 14TH ST,9,667800,173100,840900,1936,2005
236 N 22ND ST,16,378000,361600,739600,2002,2005
219 N 22ND ST,7,375500,83000,458500,1952,2006
112 N 3RD ST,6,367500,73500,441000,1935,2006
108 SHORE AVE,38,415800,225500,641300,1976,2004
2306 N CENTRAL AVE,2,350000,148200,498200,1950,2007
600 N BARNEGAT AVE,42,350000,167500,517500,1954,2007
265 S 2ND ST,25,350000,169600,519600,1941,2007
201 S LONG BEACH BLVD,12,399000,509200,908200,2006,2007
36 N 24TH ST,14,552000,464700,1016700,2003,2007
294 N 1ST ST,40,350000,221000,571000,1970,2007
377 N 4TH ST,31,378000,242500,620500,1993,2005
219 N 19TH ST,9,335400,224200,559600,1994,2000
45 N 3RD ST,19,496800,57400,554200,1956,2006
119 N 14TH ST,5,350000,78100,428100,1948,2006
249 N 2ND ST,19,350000,186300,536300,1960,2006
311 S 2ND ST,5,350000,128900,478900,1955,2005
269 N 10TH ST,27,350000,175100,525100,1985,2005
222 N 9TH ST,10,350000,474500,824500,2005,2005
226 N 20TH ST,12,396100,114200,510300,1951,2005
223 N 3RD ST,9,350000,107500,457500,1966,2005
273 N 12TH ST,29,350000,138300,488300,1955,2006
2303 BAY FRONT,15,760000,191700,951700,1964,2006
115 N 2ND ST,5,350000,155100,505100,1977,2000
312 N 4TH ST,6,350000,128700,478700,1965,2000
393 N 4TH ST,37,760000,225400,985400,1977,2006
258 DIVISION AVE,24,350000,71400,421400,1961,2006
1412 N CENTRAL AVE,3,352100,110300,462400,1945,2006
228 N 6TH ST,16,595000,143800,738800,1955,2006
216 N 8TH ST,8,350000,98000,448000,1950,2006
276 DIVISION AVE,32,350000,131500,481500,1960,2006
2100 SUNSET AVE,15,378000,95100,473100,1960,2000
343 N 12TH ST,17,378000,123900,501900,1965,2006
282 N 13TH ST,34,350000,204900,554900,1975,2006
258 N 4TH ST,24,350000,115700,465700,1970,2006
255 N 17TH ST,1,355500,154800,510300,1955,2006
913 N BARNEGAT AVE,3,350000,238300,588300,2001,2006
2201 N CENTRAL AVE,1,350000,110300,460300,1945,2005
613 N OCEAN AVE,3,1000000,200800,1200800,1973,2006
267 DIVISION AVE,27,350000,73500,423500,1955,2006
1718 N CENTRAL AVE,4,349400,195700,545100,1932,2006
323 N 1ST ST,9,375500,113700,489200,1965,2000
2201 N CENTRAL AVE,1,350000,110300,460300,1945,2006
22 N 5TH ST,10,636000,277200,913200,1990,2006
263 N 3RD ST,25,350000,173200,523200,1965,2006
411 N 4TH ST,1,827700,206100,1033800,1980,2006
26 N 6TH ST,14,572400,105900,678300,1976,2006
301 N 4TH ST,1,350000,144900,494900,1956,2006
1907 N OCEAN AVE,2,1050600,555600,1606200,1997,2006
9 N 5TH ST,1,1125000,229400,1354400,1980,2006
1306 SUNSET AVE,17,350000,106100,456100,1965,2006
266 N 6TH ST,36,350000,182100,532100,2001,2006
316 N 5TH ST,8,350000,121400,471400,1955,2006
254 N 15TH ST,4,301000,125600,426600,1960,2006
906 N CENTRAL AVE,2,350000,143800,493800,1994,2006
1608 N BARNEGAT AVE,18,424800,133800,558600,1945,2006
310 N 15TH ST,8,710300,85500,795800,1940,2006
42 N 25TH ST,12,642000,222300,864300,1952,2006
1614 SUNSET AVE,22,332500,102000,434500,1959,2006
243 N 2ND ST,17,350000,116700,466700,1965,2006
21 N 3RD ST,7,806400,182700,989100,1970,2006
1107 N BARNEGAT AVE,2,350000,109500,459500,1950,2006
28 S 2ND ST,14,615600,127400,743000,1958,2006
308 N 7TH ST,3,350000,163400,513400,1955,2006
200 N 23RD ST,4,350000,220400,570400,1951,2006
332 N 11TH ST,14,378000,114400,492400,1959,2007
16 N 10TH ST,8,678000,230500,908500,1985,2007
214 N 16TH ST,8,315000,141900,456900,1950,2007
22 N 25TH ST,4,648000,218200,866200,1954,2007
16 SHORE AVE,40,360500,187000,547500,1969,2007
112 S BARNEGAT AVE,38,326300,156900,483200,2000,2007
912 N CENTRAL AVE,3,350000,157400,507400,1965,2007
236 N 15TH ST,18,315000,130500,445500,1986,2000
17 N 7TH ST,7,678000,722000,1400000,2006,2007
286 N 6TH ST,44,315000,67400,382400,1967,2007
19 N 5TH ST,7,678000,231300,909300,1993,2007
358 N 4TH ST,24,376000,112300,488300,1961,2007
15 N 15TH ST,5,675000,610200,1285200,2006,2007
114 N 17TH ST,8,393800,390600,784400,1962,2007
270 N 14TH ST,12,315000,157500,472500,1950,2007
236 N 4TH ST,16,350000,312200,662200,2002,2007
24 N 3RD ST,0,653400,544000,1197400,2006,2007
236 N 24TH ST,16,400500,163000,563500,1978,2007
1815 N OCEAN TER,6,720000,670100,1390100,1984,2007
118 N 18TH ST,6,367500,329200,696700,2002,2007
47 N 19TH ST,19,552000,239600,791600,1980,2007
228 N 2ND ST,12,350000,146100,496100,1960,2007
327 N 7TH ST,11,350000,124200,474200,1965,2007
352 N 6TH ST,22,376000,395400,771400,2004,2007
233 N 10TH ST,13,350000,169100,519100,1935,2007
501 N BARNEGAT AVE,1,350000,185200,535200,1950,2007
116 N 22ND ST,6,315000,203400,518400,1997,2007
231 N 14TH ST,17,350000,115900,465900,1974,2007
414 N 3RD ST,6,902900,469000,1371900,1972,2007
42 N 17TH ST,18,577800,222800,800600,1960,2007
331 N 2ND ST,13,350000,283800,633800,1990,2007
122 N 19TH ST,4,303800,59100,362900,1950,2007
267 N 11TH ST,27,350000,313800,663800,1970,2007
24 S 2ND ST,12,653400,122800,776200,1970,2007
2307 N OCEAN AVE,2,1050000,569400,1619400,1960,2007
713 N BARNEGAT AVE,3,350000,214800,564800,1965,2007
422 N 3RD ST,10,902900,415400,1318300,1980,2007
106 N CENTRAL AVE,2,350000,111800,461800,1969,2007
316 N 6TH ST,8,350000,130400,480400,1965,2007
20 N 22ND ST,6,636500,399800,1036300,2007,2007
801 N OCEAN AVE,1,1000000,780500,1780500,2006,2007
1501 N OCEAN AVE,1,1050000,576800,1626800,1997,2007
34 DIVISION AVE,14,749700,643300,1393000,2006,2007
20 N 3RD ST,0,653400,472800,1126200,2006,2007
253 N 12TH ST,21,350000,114200,464200,1959,2007
267 N 6TH ST,31,350000,153000,503000,1962,2007
276 N 16TH ST,12,376500,123000,499500,1960,2007
503 N CENTRAL AVE,2,350000,227400,577400,2001,2007
250 N 3RD ST,22,350000,342900,692900,1992,2007
343 N 4TH ST,17,350000,150700,500700,1959,2007
215 N 18TH ST,7,355500,162000,517500,1940,2007
124 N 23RD ST,4,350000,129700,479700,1960,2000
258 N 14TH ST,6,315000,81700,396700,1932,2008
270 N 4TH ST,30,350000,106600,456600,1969,2008
26 N 12TH ST,12,594000,312300,906300,1950,2008
510 N CENTRAL AVE,2,315900,270500,586400,2000,2000
1 S 3RD ST,1,1664300,439900,2104200,1985,2007
200 N 17TH ST,5,303800,135600,439400,1930,2008
1105 N OCEAN AVE,0,1650000,905000,2555000,2007,2008
366 N 5TH ST,28,376000,143700,519700,1956,2008
2209 N CENTRAL AVE,3,350000,123500,473500,1952,2008
222 N 3RD ST,10,350000,157500,507500,1970,2008
509 N OCEAN AVE,2,845000,255900,1100900,1930,2008
215 S LONG BEACH BLVD,11,399000,509200,908200,2007,2008
343 N 10TH ST,17,378000,125900,503900,1959,2007
212 N BARNEGAT AVE,39,350000,306300,656300,2001,2001
313 N 9TH ST,5,350000,166300,516300,1968,2007
237 N 5TH ST,15,350000,130000,480000,1958,2007
412 N BARNEGAT AVE,39,350000,109500,459500,1955,2007
17 DIVISION AVE,9,637200,113700,750900,1950,2008
49 N 3RD ST,21,496800,104200,601000,1960,2008
482 SCHODERER LN,30,854500,638300,1492800,1988,2000
329 N 12TH ST,11,378000,632300,1010300,2008,2009
440 SCHODERER LN,18,913400,348400,1261800,1983,2009
1404 N CENTRAL AVE,2,336000,115400,451400,1940,2009
342 S 2ND ST,18,378000,189600,567600,1968,2009
222 N 11TH ST,10,350000,181900,531900,1950,2008
1402 SUNSET AVE,20,393800,204800,598600,1959,2009
27 N 7TH ST,11,481700,107600,589300,1950,2008
427 N 4TH ST,9,827700,341000,1168700,1984,2008
243 S 1ST ST,17,350000,103100,453100,1967,2008
259 N 1ST ST,23,350000,98600,448600,1962,2008
304 N 8TH ST,4,350000,193800,543800,1965,2008
16 N 11TH ST,8,750000,773700,1523700,2007,2008
1515 N OCEAN TERR,6,675000,529800,1204800,2006,2008
23 N 4TH ST,9,726000,397200,1123200,2005,2008
283 DIVISION AVE,33,350000,139200,489200,1960,2000
116 DIVISION AVE,6,315000,117400,432400,1985,2008
291 DIVISION AVE,37,376300,147400,523700,1968,2008
338 N 6TH ST,16,350000,139800,489800,1963,2008
226 N 3RD ST,12,350000,138400,488400,1983,2008
226 N 5TH ST,12,350000,155100,505100,1975,2008
613 N BARNEGAT AVE,2,350000,365900,715900,1999,2008
327 N 11TH ST,11,376000,128500,504500,1980,2008
1900 N CENTRAL AVE,1,416500,203600,620100,1970,2008
213 N 16TH ST,9,315000,263400,578400,1999,2008
275 N 15TH ST,11,376500,155300,531800,1960,2008
43 N 22ND ST,17,627000,207000,834000,1940,2008
1317 N CENTRAL AVE,4,336000,143700,479700,1981,2000
108 S CENTRAL AVE,3,339500,145000,484500,1960,2008
115 N 23RD ST,5,350000,590800,940800,2008,2008
289 N 6TH ST,41,315000,70300,385300,1924,2008
114 S CENTRAL AVE,2,291300,275700,567000,2006,2008
253 S 1ST ST,21,350000,106100,456100,1960,2008
311 S 2ND ST,5,350000,141300,491300,1955,2009
22 N 9TH ST,10,636000,606400,1242400,2006,2009
5 N 10TH ST,1,1000000,420000,1420000,1997,2009
41 N 14TH ST,17,513600,126200,639800,1934,2009
1109 N OCEAN AVE,0,1600000,956900,2556900,2007,2009
38 N 22ND ST,16,588000,144000,732000,1950,2009
901 N OCEAN AVE,1,1150000,595000,1745000,2009,2009
324 N 2ND ST,10,375500,225800,601300,1964,2009
236 N 12TH ST,16,350000,120700,470700,1955,2009
207 N 21ST ST,1,350000,179300,529300,1986,2001
19 DIVISION AVE,11,572400,366800,939200,2000,2009
17 N 8TH ST,7,720000,156600,876600,1960,2008
122 S 1ST ST,4,372400,216300,588700,1957,2009
249 N 7TH ST,19,350000,482200,832200,2008,2009
305 N 7TH ST,1,350000,164700,514700,1965,2009
38 N 22ND ST,16,588000,144000,732000,1950,2009
218 N 6TH ST,12,362300,211400,573700,1917,2009
124 N 7TH ST,3,377300,128300,505600,1950,2009
267 N 5TH ST,27,350000,143000,493000,1965,2001
383 N 3RD ST,33,377000,177700,554700,1965,2009
338 N 8TH ST,16,377000,115100,492100,1965,2009
212 N 9TH ST,6,350000,267700,617700,2000,2009
201 N 2ND ST,0,350000,328500,678500,2001,2009
209 N 20TH ST,3,315000,285500,600500,2002,2009
513 N BARNEGAT AVE,3,350000,278100,628100,1998,2009
1017 N OCEAN AVE,4,1000000,454400,1454400,1985,2009
118 N 1ST ST,8,338000,104900,442900,1961,2009
319 N CENTRAL AVE,4,350000,221500,571500,1972,2009
257 N 13TH ST,3,350000,140000,490000,1955,2009
280 N 14TH ST,16,315000,154200,469200,1940,2009
1805 N OCEAN TERR,5,648000,379100,1027100,1998,2009
107 N 9TH ST,9,315900,96500,412400,1930,2009
261 N 17TH ST,5,375500,114100,489600,1957,2009
45 DIVISION AVE,21,577800,207200,785000,1960,2009
229 N 16TH ST,15,367500,292900,660400,2009,2009
1605 N OCEAN AVE,2,1035000,403200,1438200,2007,2009
267 DIVISION AVE,27,350000,105100,455100,1955,2009
266 N 3RD ST,28,350000,159100,509100,1962,2009
27 N 24TH ST,7,636000,355800,991800,1985,2009
38 N 10TH ST,16,552000,611200,1163200,2008,2009
248 N 2ND ST,0,350000,118700,468700,1962,2010
263 N 2ND ST,25,350000,189700,539700,1960,2009
1513 N OCEAN AVE,3,1000000,601200,1601200,2003,2009
313 N 9TH ST,5,350000,166300,516300,1968,2010
414 N 3RD ST,6,902900,469000,1371900,1972,2010
32 N 19TH ST,12,604200,299500,903700,1987,2010
42 N 18TH ST,18,496800,83300,580100,1940,2010
44 N 22ND ST,18,588000,557500,1145500,2009,2010
239 N 22ND ST,15,377000,339100,716100,2002,2010
272 N 7TH ST,32,315000,272400,587400,2006,2010
124 N 12TH ST,4,350000,136300,486300,1950,2010
212 N 20TH ST,6,315000,285100,600100,2003,2010
7 S CENTRAL AVE,3,350000,657000,1007000,2007,2010
243 N 2ND ST,17,350000,145000,495000,1965,2010
41 N 19TH ST,17,552000,212700,764700,1960,2010
21 N 18TH ST,7,610200,217200,827400,1983,2010
323 N 5TH ST,9,350000,92900,442900,1960,2000
237 N 14TH ST,19,350000,135700,485700,1986,2010
1420 SUNSET AVE,21,393800,245700,639500,1949,2010
26 N 23RD ST,12,636000,404500,1040500,1991,2010
1612 N BARNEGAT AVE,19,609000,131100,740100,1940,2010
228 N 2ND ST,12,350000,146100,496100,1960,2010
222 N 3RD ST,10,350000,157500,507500,1970,2010
210 N 11TH ST,6,350000,275000,625000,1990,2000
226 N 24TH ST,12,377000,221500,598500,1984,2010
213 N OCEAN AVE,3,1150000,438200,1588200,2005,2010
217 N 9TH ST,0,350000,314500,664500,1989,2010
112 N CENTRAL AVE,3,350000,76200,426200,1950,2010
112 N 7TH ST,6,412600,163200,575800,1955,2010
7 S OCEAN AVE,2,1017000,220200,1237200,1962,2010
372 N 10TH ST,30,400500,120500,521000,1958,2010
